%%%%%%%%%%%%%%%%%%%%%
%                  .%
%                   %
%                   %
%                   %
%       . P         %
%                   %
%                   %
%                   %
%                   %
%%%%%%%%%%%%%%%%%%%%%