%%%%%%%%%%%%%%%%%%%%
%.%P          %    %
%%%% %% %% %% %% % %
%                % %
%%%%%%%%%%%%%%%%%% %
%.%.               %
%%%%%%%%%%%%%%%%%%%%
