%%%%%%%%%%%%%%%%%%%%
%.%P          %    %
%%%% %% %% %% %% % %
%                % %
%%%%%%%%%%%%%%%%%% %
%.%............    %
%%%%%%%%%%%%%%%%%%%%
