%%%%%%%%%
%..   ..%
%%%%.%% %
%%  P   %
%.%% %%.%
%.%.   .%
%%%%%%%%%
