%%%%%%%%%%%%%%%%%%%%
%o...%....... % ..P%
%.%%.%.%%..%% % %% %
%...... G G %  ....%
%.%.%%.%% %%% %% %.%
%.%....% ooo% %  %.%
%.%.%%.% %% % % %%.%
%o%.....      %....%
%%%%%%%%%%%%%%%%%%%%
